0 1 2 3
########^########
#...............#
#...............#
#.......@.......#
#...............#
#...............#
<.......A.......>
#...............#
#...............#
#...............#
#...............#
#...............#
########v########