0 2
########^########
#...............#
#...............#
#.......@.......#
#...............#
#...............#
#.......A.......#
#...............#
#...............#
#...............#
#...............#
#...............#
########v########