0 2
########^########
#R.............R#
#...........@...#
#...............#
#.......R.......#
#...000000000...#
#...0000E0000...#
#...000000000...#
#.......R.......#
#...............#
#...............#
#R.............R#
########v########