0 1 2 3
########^########
#...............#
#.@.............#
#...............#
#...............#
#...............#
<.......B.......>
#...............#
#...............#
#...............#
#...............#
#...............#
########v########