0 1 2 3
########^########
#...............#
#...............#
#.....RR.RR.....#
#....R.....R....#
#....R.....R....#
<@...R.....R....>
#....R.....R....#
#....R.....R....#
#.....RRRRR.....#
#...............#
#...............#
########v########