########D########0
#.......A.......#
#...............#
#.....##.##.....#
#....#.....#....#
#....#.....#....#
D@...#.....#....D
#....#.....#....#
#....#.....#....#
#.....#####.....#
#....A..........#
#...............#
########D########