1 3
#################
#.......@.......#
#...............#
#..R0.......0R..#
#..0....R....0..#
#......RRR......#
<.....RR.RR.....>
#......RRR......#
#..0....R....0..#
#..R0.......0R..#
#...............#
#...............#
#################