########D########0
#...............#
#...............#
#.....##.##.....#
#....#.....#....#
#....#.....#....#
D@...#.....#....D
#....#.....#....#
#....#.....#....#
#.....#####.....#
#...............#
#...............#
########D########