0 1 2 3
########^########
#...............#
#...........A...#
#.....R..RR.....#
#....R.....R....#
#....R.....R....#
<@...R..E..R....>
#....R.....R....#
#....R.....R....#
#.....RRRRR.....#
#...............#
#...............#
########v########