0 2
########^########
#...............#
#...............#
#.....RR.RR.....#
#....R.....R....#
#....R.E.E.R....#
#@...R.....R....#
#....R.E.E.R....#
#....R.....R....#
#.....RRRRR.....#
#...............#
#...............#
########v########