########D########0
#...............#1
#...............#2
#.....##.##.....#3
#....#.....#....#4
#....#.....#....#5
D@...#.....#....D6
#....#.....#....#7
#....#.....#....#8
#.....#####.....#9
#...............#10
#...............#11
########D########12
01234567890123456