1 3
#################
#0..000...000..0#
#000000000000000#
#000000000000000#
#000000000000000#
<@..............>
#000000000000000#
#000000000000000#
#000000000000000#
#000000000000000#
#000000000000000#
#0000..000..0000#
#################
