1 3
#################
#0.E000.E.000E.0#
#000000000000000#
#000000000000000#
#000000000000000#
<@..............>
#000000000000000#
#000000000000000#
#000000000000000#
#000000000000000#
#000000000000000#
#0000.E000E.0000#
#################
