0 2
########^########
#...............#
#.RR....@.......#
#.RR............#
#...............#
#..E...000......#
#......000......#
#......000......#
#...............#
#............RR.#
#..........E.RR.#
#...............#
########v########
