0 2
########^########
#...............#
#.RR....@.......#
#.RR............#
#...............#
#......000......#
#......000......#
#......000......#
#...............#
#............RR.#
#............RR.#
#...............#
########v########
