########D########
#...............#
#.##....@.......#
#.##............#
#...............#
#......000......#
#......000......#
#......000......#
#...............#
#............##.#
#............##.#
#...............#
########D########
