########D########0
#...............#1
#.##....@.......#2
#.##............#3
#...............#4
#......000......#5
#......000......#6
#......000......#7
#...............#8
#............##.#9
#............##.#10
#...............#11
########D########12
01234567890123456