0 2
########^########
#R.0........RRRR#
#R.0........RRRR#
#R.0.R..........#
#E.0............#
#..0.R..........#
#R.0....@.......#
#..0.R..........#
#E.0............#
#R.0.R..........#
#R.0........RRRR#
#R.0........RRRR#
########v########