0 1 2 3
########^########
#0000000.0000000#
#0000000@0000000#
#0000000.0000000#
#0000000.0000000#
<.............A.>
#0000000.0000000#
#0000000.0000000#
#0000000.0000000#
#0000000.0000000#
#0000000.0000000#
#0000000.0000000#
########v########