0 2
########^########
#0.00000.00000.0#
#0.0000...0000.0#
#0.000000.0000.0#
#0.0000...0000.0#
#0.0000.000000.0#
#0.0000.@.0000.0#
#0.000000.0000.0#
#0.0000...0000.0#
#0.0000.000000.0#
#0.0000...0000.0#
#0.00000.00000.0#
########v########