0 1 2 3
########^########
#00.............#
#00.............#
#00.............#
#...............#
#......000......#
<@.....0E0......>
#......000......#
#...............#
#.............00#
#.............00#
#.............00#
########v########