0 1 3
########^########
#...............#
#...............#
#....#.....#....#
#...............#
#.......#.......#
<........@......>
#...............#
#..#..00000..#..#
#.#..0000000..#.#
#...000...000...#
#000000000000000#
#################