0 1 3
########^########
#...............#
#...............#
#....R.....R....#
#...............#
#.......R.......#
<........@......>
#...............#
#..R..00000..R..#
#.R..0000000..R.#
#E.E000...000E.E#
#000000000000000#
#################