0 1 2 3
########^########
#...............#
#.........RR....#
#...............#
#...RR..........#
#...............#
<.......@.......>
#...............#
#.........RR....#
#....RR.........#
#...............#
#...............#
########v########