0 1 2 3
########^########
#000.........000#
#0.............0#
#0.............0#
#.......R.......#
#...............#
<.......@.......>
#...............#
#...............#
#......0.0......#
#.....00.00.....#
#.E..000.000..E.#
########v########