0 1 2 
########^########
#RRR...........R#
#RR...........RR#
#R...........RRR#
#.............RR#
#..............R#
<.......@.......#
#...............#
#.............E.#
#R.........R....#
#RR........RRE..#
#RRR.......RRR..#
########v########