0 1 2 
########^########
#RRR........E..R#
#RR...........RR#
#R...........RRR#
#.............RR#
#..............R#
<.......@.......>
#...............#
#...............#
#R.........R....#
#RR........RRE..#
#RRR.......RRR..#
########v########