0 1 2 3
########^########
#000000...000000#
#00000.....00000#
#0000...0...0000#
#000...000....00#
#00...00000...00#
<@...0000000....>
#00...00000...00#
#000...000...000#
#0000...0...0000#
#00000.....00000#
#000000...000000#
########v########