#################
#...............#
#...............#
#...............#
#...............#
#...............#
#.............@.D
#...............#
#...............#
#..A..A..A..A...#
#...............#
#...............#
#################