1 3
########^########
#...............#
#...............#
#...............#
#...............#
#...............#
<.............@.>
#...............#
#...............#
#..A..A..A..A...#
#...............#
#...............#
########v########