########D########0
#0000000.......0#1
#0......@......0#2
#0.............0#3
#0.............0#4
#0.............0#5
#0.............0#6
#0.............0#7
#0.............0#8
#0.............0#9
#0.............0#10
#0.......0000000#11
########D########12
01234567890123456