1 3
#################
#...............#
#.R...RRRRR...R.#
#.....RRRRR.....#
#.....RRRRR.....#
#...............#
<.......@.......>
#...............#
#.....RRRRR.....#
#.....RRRRR.....#
#.R...RRRRR...R.#
#...............#
#################