0 2
########^########
#0000.......0000#
#00000........00#
#00000.........0#
#0E.00.........0#
#0..00.........0#
#0.E00...@.....0#
#0..00.........0#
#0E.00.........0#
#00000.........0#
#00000........00#
#0000.......0000#
########v########