########D########
#0000000.0000000#
#0000000@0000000#
#0000000.0000000#
#0000000.0000000#
D.............A.D5
#0000000.0000000#
#0000000.0000000#
#0000000.0000000#
#0000000.0000000#
#0000000.0000000#
#0000000.0000000#
########D########