##################
#................#
#.#..............#
#.....#..........#
#...@............#
#................#
#.#..............#
#....#...........#
#................#
#................#
#................#
#................#
#................#
##################